"filename", "language", "Lua", "GLSL", "comment", "blank", "total"
"/Users/ianbetz/Desktop/Coding/Lua Projects/SrProj/engine/components/PhysicsBody.lua", "Lua", 62, 0, 5, 21, 88
"/Users/ianbetz/Desktop/Coding/Lua Projects/SrProj/engine/components/PhysicsGridUpdater.lua", "Lua", 60, 0, 7, 19, 86
"/Users/ianbetz/Desktop/Coding/Lua Projects/SrProj/engine/components/RigidBody.lua", "Lua", 64, 0, 15, 36, 115
"/Users/ianbetz/Desktop/Coding/Lua Projects/SrProj/engine/components/Texture.lua", "Lua", 32, 0, 3, 8, 43
"/Users/ianbetz/Desktop/Coding/Lua Projects/SrProj/engine/components/WorldBody.lua", "Lua", 31, 0, 3, 9, 43
"/Users/ianbetz/Desktop/Coding/Lua Projects/SrProj/engine/components/Ysort.lua", "Lua", 27, 0, 1, 10, 38
"/Users/ianbetz/Desktop/Coding/Lua Projects/SrProj/engine/init.lua", "Lua", 63, 0, 4, 18, 85
"/Users/ianbetz/Desktop/Coding/Lua Projects/SrProj/engine/internal/Entity.lua", "Lua", 76, 0, 8, 19, 103
"/Users/ianbetz/Desktop/Coding/Lua Projects/SrProj/engine/internal/EventHandler.lua", "Lua", 31, 0, 4, 8, 43
"/Users/ianbetz/Desktop/Coding/Lua Projects/SrProj/engine/internal/Lighting/Body.lua", "Lua", 123, 0, 17, 49, 189
"/Users/ianbetz/Desktop/Coding/Lua Projects/SrProj/engine/internal/Lighting/Light.lua", "Lua", 69, 0, 10, 37, 116
"/Users/ianbetz/Desktop/Coding/Lua Projects/SrProj/engine/internal/Lighting/LightWorld.lua", "Lua", 165, 0, 31, 88, 284
"/Users/ianbetz/Desktop/Coding/Lua Projects/SrProj/engine/internal/Lighting/init.lua", "Lua", 6, 0, 0, 1, 7
"/Users/ianbetz/Desktop/Coding/Lua Projects/SrProj/engine/internal/Scene.lua", "Lua", 22, 0, 4, 7, 33
"/Users/ianbetz/Desktop/Coding/Lua Projects/SrProj/engine/internal/Stack.lua", "Lua", 30, 0, 5, 12, 47
"/Users/ianbetz/Desktop/Coding/Lua Projects/SrProj/engine/internal/World.lua", "Lua", 84, 0, 21, 33, 138
"/Users/ianbetz/Desktop/Coding/Lua Projects/SrProj/engine/util/Array3D.lua", "Lua", 38, 0, 4, 16, 58
"/Users/ianbetz/Desktop/Coding/Lua Projects/SrProj/engine/util/HSV.lua", "Lua", 15, 0, 2, 6, 23
"/Users/ianbetz/Desktop/Coding/Lua Projects/SrProj/engine/util/Matrix.lua", "Lua", 27, 0, 0, 8, 35
"/Users/ianbetz/Desktop/Coding/Lua Projects/SrProj/engine/util/Object.lua", "Lua", 18, 0, 4, 8, 30
"/Users/ianbetz/Desktop/Coding/Lua Projects/SrProj/engine/util/UUID.lua", "Lua", 7, 0, 0, 4, 11
"/Users/ianbetz/Desktop/Coding/Lua Projects/SrProj/engine/util/Vector.lua", "Lua", 120, 0, 36, 53, 209
"/Users/ianbetz/Desktop/Coding/Lua Projects/SrProj/engine/util/aabb.lua", "Lua", 6, 0, 0, 0, 6
"/Users/ianbetz/Desktop/Coding/Lua Projects/SrProj/game/init.lua", "Lua", 24, 0, 0, 6, 30
"/Users/ianbetz/Desktop/Coding/Lua Projects/SrProj/main.lua", "Lua", 54, 0, 1, 21, 76
"/Users/ianbetz/Desktop/Coding/Lua Projects/SrProj/ref.lua", "Lua", 254, 0, 2, 136, 392
"/Users/ianbetz/Desktop/Coding/Lua Projects/SrProj/shaders/blur.frag", "GLSL", 0, 14, 3, 11, 28
"/Users/ianbetz/Desktop/Coding/Lua Projects/SrProj/shaders/glow.frag", "GLSL", 0, 15, 0, 4, 19
"/Users/ianbetz/Desktop/Coding/Lua Projects/SrProj/shaders/light.frag", "GLSL", 0, 13, 6, 11, 30
"/Users/ianbetz/Desktop/Coding/Lua Projects/SrProj/shaders/normal.frag", "GLSL", 0, 12, 6, 8, 26
"Total", "-", 1508, 54, 202, 667, 2431